11111111111111111111111111111111111111111111111111
11111111111111111111111111100000000000000111111111
11111111111111111111111111101111111111110111111111
10000011111110000000000000001111111111110111111111
10111000000000111111111101111111111111110111111111
10111111111111111111111101101111111111110111111111
10111000000000111111111100100001000000100111111111
10111011111110111111111101110111011110101111111111
10111011111110111111111101111111011110101111111111
10111000000000111111111101110000011110101111111111
10111011111100111111111101110111111110101111111111
10111011111100111111111101110000000000100000000011
10111011111100111111111101110111111111111111111011
10111011111100111111111101110111111111111111111011
10111011111100111111111111110111111111111111111011
10111011111100000000000000000000100000000000010011
10111011111101111111111011111111111111110111010111
10111011111101111111111011111111111111110111010000
10111011111101111111111011111111111111110111010110
10111111111101000010011000100000000000100111010110
10111001111101011111011000101111011110101111010110
10111000001001011111011000101111000000101111010110
10111011011101000100011000101111111111101111011110
10111011011101110101111000101111000000101111010000
10111011011101110101111000101111011110101111010111
10010011011100000100000000100000011110101111010111
11010000011111111111111111111111011110101111010111
11011111011101111111111111111111111110101111110111
11011111000000000000000000000000000000101111010111
11011111110111111111111111111111111110101111010111
11011111110111111111111111111111111110100000010000
11011111110111111111111111111111111111101111111110
00001000000000100000000000000000100000101111111110
01111111110111111000001111011111111100101111111110
01111111111111111011101111011111111100101111111110
00100000000111111011100000011111111100001111111110
00110111110111111011111111111111111101101111111110
10110000000111111011100000011111111101100000010000
10111111110111111011101111011111111100000000010001
10110111110111111011101111011111111100111111111101
10110111110111111011101111011111111100010010000101
10110111110111111011101111011111111101111010110100
10110111110001000011101111011111111101111010110110
10110111110101011011101111011111111101111010110110
10110000000001000011101111011111111101111010000110
10111111111111111111101111011111111111111011111110
10110000000000000011101111011111111101111110000110
10000111111111111000001111000000000000000010110110
11111111111111111111111111111111111111111000110110
11111111111111111111111111111111111111111111110000